1111111111111
1010000001001
111100C000011
1E000C00010P1
1111111111111