1111111111111
10X000000X001
1XXX00C000011
1E000C00010P1
1111111111111