11111111111111111111111111111111111111111111111111111111111111111111111111111111
10000000000000000000000000000000000000000000000000000000000000000000000000000001
10000000000000000000000000XP00000000000000000000000000C0000000000000C11111111111
1000000000000000000000000000000000000000C000000000000000000000000001111C00000011
1000000000000000000000000000000000000000C000000000000000000000000001111111100001
10000000000000000000000000000000000000000000000000000000000000000000000000000001
10000000000000000000000000000000000000000000000000000000000000000000000000000001
10000000000000000000000000000C00000000000000000000000000000000000000000000000001
10000C0000000000000000000000000000000000000000000000000000000000000000000E000001
11111111111111111111111111111111111111111111111111111111111111111111111111111111